###################
#F.......#........#
#.##.###.#.###.##.#
#.................#
#.##.#.#####.#.##.#
#....#...#...#....#
####.###.#.###.####
***#.#...R...#.#***
####.#.##D##.#.####
***N...#B*O#...N***
####.#.#####.#.####
***#.#.......#.#***
####.#.#####.#.####
#........#........#
#.##.###.#.###.##.#
#..#.....C.....#..#
##.#.#.#####.#.#.##
#....#...#...#....#
#.######.#.######.#
#................F#
###################