###################
#F.......#........#
#.##.###.#.###.##.#
#.................#
#.##.#.#####.#.##.#
#.F..#...#...#.F..#
####.###.#.###.####
***#.#...R...#.#***
####.#.##D##.#.####
***N...#***#...N***
####.#.#####.#.####
***#F#......F#.#***
####.#.#####.#.####
#........#.....F..#
#.##.###.#.###.##.#
#..#...F.C.....#..#
##.#.#.#####.#.#.##
#.F..#...#...#....#
#.######.#.######.#
#.....F..........F#
###################