###################
#F.......#........#
#.##.###.#.###.##.#
#.................#
#.##.#.#####.#.##.#
#....#...#...#....#
####.###.#.###.####
***#.#...R...#.#***
####.#.##D##.#.####
***N...#***#...N***
####.#.#####.#.####
***#.#.......#.#***
####.#.#####.#.####
#........#........#
#.##.###.#.###.##.#
#..#...F.C.....#..#
##.#.#.#####.#.#.##
#....#...#...#....#
#.######.#.######.#
#................F#
###################