###################
#........#........#
#.##.###.#.###.##.#
#.................#
#.##.#.#####.#.##.#
#....#...#...#....#
####.###.#.###.####
***#.#...R...#.#***
####.#.##D##.#.####
****...#***#...****
####.#.#####.#.####
***#.#.......#.#***
####.#.#####.#.####
#........#........#
#.##.###.#.###.##.#
#..#.....C.....#..#
##.#.#.#####.#.#.##
#....#...#...#....#
#.######.#.######.#
#.................#
###################