###################
#........#........#
#.##.###.#.###.##.#
#.................#
#.##.#.#####.#.##.#
#....#...#...#....#
####.###.#.###.####
   #.#...R...#.#
####.#.## ##.#.####
    ...#BPO#...
####.#.#####.#.####
   #.#.......#.#
####.#.#####.#.####
#........#........#
#.##.###.#.###.##.#
#..#.....C.....#..#
##.#.#.#####.#.#.##
#....#...#...#....#
#.######.#.######.#
#.................#
###################