####################
#..................#
####################
#......C...........#
#######.############
#######.############
#######.############
#..................#
#..................#
#..................#
#..................#
#..................#
#..................#
#..................#
####################