###################
#........#........#
#.##.###.#.###.##.#
#.................#
#.##.#.#####.#.##.#
#....#.......#....#
###.###.###.###.###
  #.#.........#.#
###.#.### ###.#.###
......#     #......
###.#.#######.#.###
  #.#.........#.#
###.#.#######.#.###
#........#........#
#.##.###.#.###.##.#
#..#.....C.....#..#
##.#.#.#####.#.#.##
#....#...#...#....#
#.######.#.######.#
#.................#
###################