##########
#........#
#..C.....#
#........#
##########